NO ./textures/cub3d/north.xpm
SO ./textures/cub3d/south.xpm
WE ./textures/cub3d/west.xpm
EA ./textures/cub3d/east.xpm
F 139,90,43
C 135,206,235


111111111111111111111
1010000100001000010101
100000000000000000001
101000000001000010101
101000100001000000101
101000100001000010101
101000100000000010101
101000100001000010101
101000100001000010101
1110011000101010010111
101010101010101010101
101010101010101010101
100000000S00000000001
101110010010111000001
101000010010110000001
100110011111111000001
111111111111111111111



