NO ./textures/cyber_lab/north.xpm
SO ./textures/cyber_lab/south.xpm
WE ./textures/cyber_lab/west.xpm
EA ./textures/cyber_lab/east.xpm
F 139,90,43
C 135,206,235


111111111111111111111
101000100001000010101
100000100001000010101
101000000001000010101
101000100001000000101
101000100001000010101
101000100000000010101
101000100001000010101
101000100001000010101
111001100101010010111
101010101010101010101
101010101010101010101
100000000000000000001
101110010010111000001
101000010010110000001
100110011111111000001
1W000000000000000001
100000000000000000001
10000100001000100011
100100000000000000101
1111111111111111111111
