
NO ./textures/cyber_lab/north.xpm
SO ./textures/cyber_lab/south.xpm
WE ./textures/cyber_lab/west.xpm
EA ./textures/cyber_lab/east.xpm
F 0,0,0
C 0,0,0

 11111111111111111111111111111111111111111111111111111111111111111111111111111111
  100000000000000000000000000000000000000000000011111111111100000011
   100000000000000000000000000000000000000000000000000000000000000001
    100000000000000000000000000000000000000000000010000000000000000011111111111
     110000000000000000000000000000000000000000000000000000000000000000000001
111110E0000000000000000000000000000000000000000111111111100000000000000000001
     10000000000000000000000000000000000000000000001111000000000000000000011
    1000000000000000000000000000000000000000000000111100000001000000000011
   100000000000000000000000000000000000000000000011110000000011111111111
  10000000000000000000000000000000000000000000001110000001111
10000000000000000000000000000000000000000000001111111111111111
10000000000000000000000000000000000000000000000000000000000011
11111111111111111111111111111111111111111111111111111111111111111111111111111111