NO ./
SO ./
WE ./
EA ./
F 0,0,0
C 66,191,255



1
11111111111111111111111111111111111111111111111111
11111111111111111111111111111111111111111111111111
10000000000000000000000000000000000000000000000001
10000001000100001000000000010100001010010101010101111111111111111111111111111111111111111111111111111
100000010001000000000000000101000010100101010101000000000000000000000000000000000000001
100000010001000000000000000101000010100101010101011111111111111111111111111111111111111111111111111
10000001000100000000000000010100001010010101010101
10000001000100000000000000010100001010010101010101
1000000100010000000000000001010000101001010101010111111111111111111111111111111111111111111111111111
10000001000100000000000000010100000010010101010100000000000000000000000000000000000001
1000000100010100S0000000001010000101001010101010111111111111111111111111111111111111111111111111111
10000001000100000000000000010100001010010101010101
10000001000100000000000000010100001010010101010101
10000001000100000000000000010100001010010101010101111111111111111111111111111111111111111111111111111
10000001000100000001000000010100001010010101010100000000000000000000000000000000000001
100000010001000000000000000101000010100101010101011111111111111111111111111111111111111111111111111
11101111111111111111111111111111111111111111111111
11101111111111111111111111111111111111111111111111
1111111111111111111111111111111111111111111111111111