NO ./textures/simple/north.xpm
SO ./textures/simple/south.xpm
WE ./textures/simple/west.xpm
EA ./textures/simple/east.xpm
F 28,40,51 
C 46,134,193 


1111111111111111111111111111111111111111111111111111111111111111111111111
1000011110000000000000000000000000000000000000000000000000000000000000001111111111
10001101100000001111111110000001111111110000000111111110000000000000000000000000001
1001100110000000000000011000000000000011000000000000011000000000000000000011111111
10110001100000000000000110000000000000110000000000000110000000000000000011
100000011000000011111111100000011111111100000001111111100000000000000000001
10000001100000000000000110000000000000110000000000000110000000000001111111
100000011000000000000001100000000000001100000000000001100000000000000000001
10001111111100001111111110000001111111110000000000000110000000000000001111
10000000000000000000000000000000000000000000000000000000000000000001111
10000000000000000000000000000000000000000000000000000000000000000000001
10000000000000000000000000000000000000000000000000000000000000000000001
10000000000000000000000000000000000000000000000000000000000000000000001
10000000000000000000000000000000000000000000000000000000000000000001111
10000000000000000000000000000000000000000000000000000000000000000000001
10000000000000000000000000000000000000000000000000000000000000000000001
10000000000000000000000000000000000000000000000000000000000000000000001
10000000000000000000000000000000000000000000000000000000000000000001111
10000000000000000000000000000000000000000000000000000000000000000000001
10000000000000000000000000000000000000000000000000000000000000000000001
10000000000000000000000000000000N00000000000000000000000000000000000001
1111111111111111111111111111111111111111111111111111111111111111111111111




