NO ./path_to_the_north_texture
SO ./path_to_the_south_texture
WE ./path_to_the_west_texture
EA ./path_to_the_east_texture
F 0,0,0
C 66,191,255



1
11111111111111111111111111111111111111111111111111
11111111111111111111111111111111111111111111111111N
10000000000000000000000000000000000000000000000001
10000000000000000000000000000000000000000000000011
10000000000000000000000000000000000000000000000011
10000000000000000000000000000000000000000000000011
10000000000000000000000000000000000000000000000011
10000000000000000000000000000000000000000000000011
1000W000000000000000000000000000000000000000000011
10000000000000000000000000000000000000000000000011
10000000000000000000000000000000000000000000000011
10000000000000000000000000000000000000000000000011
10000000000000000000000000000000000000000000000011
11111111111111111111011111111111111111111111111111
1                  1011111111111111111111111111111
1111111111111111111101                  1111111111
10000000000000000001011111111111111111110000011111
10000000000000000000000000000000000000000100000111
10000000000000000001111111100000000000111100000111
1000000000000000001        1000000000011110000011
1000000000000000001        10000000000111100000111
1111111111111111111111111111111111111111000001111
111111111111111111111111111111111111111111111111111
